7 7 7 7 7 7 7 7 7 7 7 7 7 7 7 7
7 4 3 3 3 3 4 3 4 3 3 3 3 3 4 7
7 4 4 4 4 4 4 4 3 3 3 3 3 3 4 7
7 4 4 3 3 3 3 3 3 4 4 4 3 3 3 7
7 4 4 4 3 3 3 3 3 4 4 4 3 3 4 7
7 4 4 4 3 3 3 4 4 4 4 3 3 4 4 7
7 4 4 4 3 3 4 4 4 3 3 3 4 4 4 7
7 4 4 4 4 4 4 4 4 4 4 4 4 4 4 7
7 4 4 4 4 4 4 4 4 4 4 4 4 4 4 7
7 4 4 6 6 6 6 6 4 4 4 4 4 4 4 7
7 4 4 6 6 6 6 6 4 4 4 4 4 4 4 7
7 7 7 7 7 7 7 7 7 7 7 7 7 4 4 7