43 43 43 43 43 43 43 43 43 43 43 43 43 43 43 43 43 43 43 43 43 43 43 43 43 43 43 43 43 43 43 43 43 43 43 43 43 43 43 43 43 43 43 43 43 43 43 43 43 43 
43 43 43 43 43 43 43 43 43 43 43 43 43 43 43 43 43 43 43 43 43 43 43 43 43 43 43 43 43 43 43 43 43 43 43 43 43 43 43 43 43 43 43 43 43 43 43 43 43 43 
43 43 43 43 43 43 43 43 43 43 43 43 43 34 32 32 32 32 40 43 43 43 43 43 43 43 43 43 43 34 32 32 32 32 40 43 43 43 43 43 43 43 43 43 34 32 32 40 43 43 
43 43 43 43 43 43 43 43 43 43 43 34 32 30 25 25 25 25 39 40 43 43 43 43 43 43 43 43 34 30 7 6 7 6 39 40 43 43 43 43 43 43 43 34 30 8 25 39 40 43 
43 43 43 43 43 43 43 42 34 32 32 30 25 25 25 25 25 25 25 39 32 32 32 32 32 32 32 32 30 8 4 5 4 5 25 39 32 32 32 32 32 32 32 30 8 25 8 27 39 40 
43 43 43 43 43 43 42 34 30 27 7 6 7 6 25 25 25 25 25 25 25 25 7 6 7 6 7 6 7 6 28 29 28 29 21 20 20 20 20 20 20 20 20 20 20 20 18 25 8 38 
43 43 43 43 43 42 34 30 21 27 4 5 4 5 25 25 25 25 25 25 25 25 4 5 4 5 4 5 4 5 4 5 4 5 15 21 20 20 20 20 20 20 20 20 20 18 19 8 25 38 
43 43 43 43 42 34 30 21 17 27 2 3 2 3 25 25 25 25 25 25 25 25 2 3 28 29 28 29 28 29 28 29 28 29 15 15 25 27 27 27 27 27 27 27 25 19 19 31 41 36 
43 43 43 42 34 30 21 17 25 25 1 0 1 0 25 25 25 25 25 25 25 25 1 0 2 3 4 5 4 5 4 5 4 5 15 15 25 27 9 9 9 9 9 27 25 19 19 38 42 42 
43 43 43 42 35 27 15 25 25 25 25 25 25 25 25 25 7 6 25 25 25 25 25 25 1 0 2 3 28 29 28 29 28 29 15 15 25 27 9 9 9 9 9 27 25 19 19 38 42 42 
43 43 43 42 33 37 14 13 13 13 13 25 25 25 25 25 4 5 7 6 25 25 25 25 25 25 1 0 2 3 5 5 4 5 15 15 25 27 9 9 10 9 9 27 25 19 19 38 42 42 
43 43 43 42 42 33 41 37 27 27 27 25 25 25 25 25 2 3 4 5 7 6 25 25 25 25 25 25 1 0 2 3 28 29 15 15 25 27 27 27 25 27 27 27 25 19 19 38 42 42 
43 43 43 43 42 42 42 33 41 41 41 41 41 41 41 37 1 0 2 3 4 5 25 25 25 25 25 25 25 25 1 0 4 5 15 15 25 25 25 25 25 25 25 25 25 19 19 39 40 42 
43 43 43 43 43 43 42 42 42 42 42 42 42 42 42 33 41 37 1 0 28 29 7 6 25 25 25 25 25 25 25 25 2 3 15 14 13 11 26 26 26 24 13 13 13 12 19 25 38 42 
43 43 43 43 43 43 43 42 42 42 42 42 42 42 42 42 42 33 37 25 4 5 4 5 25 25 25 25 25 25 25 25 1 0 14 13 13 11 26 26 26 24 13 13 13 13 12 25 38 42 
43 43 43 43 43 43 43 43 43 43 43 43 43 43 43 42 42 42 35 25 2 3 28 29 25 25 25 25 25 25 25 25 25 25 25 25 25 25 25 25 25 25 25 25 7 6 25 31 36 42 
43 43 43 43 43 43 43 43 43 43 43 43 43 43 43 43 42 42 33 37 1 0 4 5 7 6 7 6 25 25 25 25 25 25 25 25 25 25 25 25 25 25 7 6 2 3 25 38 42 42 
43 43 43 43 43 43 43 43 43 43 43 43 43 43 43 43 43 42 42 33 37 25 2 3 4 5 4 5 25 25 25 25 25 25 25 25 25 25 27 25 25 25 4 5 1 0 31 36 42 43 
43 43 43 43 43 43 43 43 43 43 43 43 43 43 43 43 43 43 42 42 33 37 1 0 2 3 2 3 25 25 25 25 25 25 25 25 25 25 8 8 25 25 2 3 31 41 36 42 43 43 
43 43 43 43 43 43 43 43 43 43 43 43 43 43 43 43 43 43 43 42 42 33 41 37 1 0 1 0 25 21 11 26 24 18 25 25 25 25 25 25 25 25 1 0 38 42 42 42 43 43 
43 43 43 43 43 43 43 43 43 43 43 43 43 43 43 43 43 43 43 43 43 42 42 33 41 41 41 41 37 15 25 25 25 19 31 41 41 41 41 41 41 41 41 41 36 42 42 43 43 43 
43 43 43 43 43 43 43 43 43 43 43 43 43 43 43 43 43 43 43 43 43 43 42 42 42 42 42 42 35 15 25 25 25 19 38 42 42 42 42 42 42 42 42 42 42 42 43 43 43 43 
43 43 43 43 43 43 43 43 43 43 43 43 43 43 43 43 43 43 43 43 43 43 43 43 43 42 42 42 35 15 25 25 25 19 38 42 42 43 43 43 43 43 43 43 43 43 43 43 43 43 
43 43 43 43 43 43 43 43 43 43 43 43 43 43 43 43 43 43 43 43 43 43 43 43 43 43 42 42 35 15 25 25 25 19 38 42 43 43 43 43 43 43 43 43 43 43 43 43 43 43 
43 43 43 43 43 43 43 43 43 43 43 43 43 43 43 43 43 43 43 43 43 43 43 43 42 42 42 42 35 15 25 25 25 19 38 42 42 42 42 42 42 42 42 42 42 42 42 43 43 43 
43 43 43 43 43 43 43 43 43 43 43 43 43 43 43 43 43 43 43 43 42 42 42 42 42 42 42 42 35 15 25 25 25 19 38 42 42 34 32 32 32 32 32 32 32 40 42 42 43 43 
43 43 43 43 43 43 43 43 43 43 43 43 43 43 43 43 43 43 43 42 42 42 34 32 32 32 32 32 30 15 25 25 25 19 39 32 32 30 21 20 20 20 20 20 18 39 40 42 43 43 
43 43 43 43 43 43 43 43 43 43 43 43 43 43 43 43 42 42 42 42 34 32 30 25 8 25 25 25 25 14 11 26 24 12 7 6 21 20 17 25 25 25 25 25 16 18 39 40 43 43 
43 43 43 43 43 43 43 43 43 43 43 43 43 43 43 42 42 42 34 32 30 27 25 25 25 25 25 25 25 25 25 25 25 25 4 5 15 31 41 41 41 37 25 25 25 16 18 38 43 43 
43 43 43 43 43 43 43 43 43 43 43 43 42 42 42 42 34 32 30 8 25 25 25 25 25 25 25 25 25 25 25 25 25 25 2 3 15 38 42 42 42 33 37 25 25 25 19 38 43 43 
43 43 43 43 43 43 43 43 43 43 43 42 42 42 34 32 30 8 25 25 25 25 25 25 25 25 25 25 25 25 25 25 25 25 1 0 15 38 42 42 42 42 35 25 25 25 19 38 43 43 
43 43 43 43 43 43 43 42 42 42 42 42 34 32 30 8 25 25 25 25 25 25 25 25 25 25 25 25 25 25 25 25 21 20 20 20 17 38 42 43 42 42 35 25 25 25 19 38 43 43 
43 43 43 43 43 43 42 34 32 32 32 32 30 25 8 8 25 25 25 25 25 25 25 25 27 25 25 25 25 25 25 25 15 31 41 41 41 36 42 43 42 42 35 25 25 25 19 38 43 43 
43 43 43 43 43 42 34 30 8 27 27 27 25 25 25 25 25 25 25 25 25 25 25 25 8 8 25 25 25 25 25 25 15 38 42 42 42 42 42 43 42 34 30 25 25 25 19 38 43 43 
43 43 43 43 42 34 30 8 25 25 25 25 25 25 25 25 25 25 25 25 25 25 25 25 8 8 25 25 25 25 21 20 17 38 42 43 43 43 43 43 42 35 25 25 25 27 19 38 43 43 
43 43 43 43 34 30 25 25 25 25 25 25 25 25 27 8 8 25 25 25 25 25 25 25 27 25 25 25 25 25 15 31 41 36 42 43 43 43 43 42 42 35 25 25 27 8 19 38 43 43 
43 43 43 43 35 8 7 6 25 25 25 25 25 8 27 25 27 25 25 25 25 25 25 25 25 25 25 25 25 25 15 39 32 40 42 43 43 43 43 42 34 30 25 25 25 8 19 38 43 43 
43 43 43 43 35 8 4 5 7 6 25 25 25 25 25 25 25 25 25 25 25 25 25 25 25 25 25 25 25 25 14 13 23 38 42 43 43 43 43 42 35 25 25 25 25 8 19 38 43 43 
43 43 43 43 35 8 28 29 4 5 25 25 25 25 25 25 25 25 25 25 25 25 25 25 25 25 25 25 25 25 25 25 15 38 42 42 42 42 42 34 30 25 25 25 25 27 19 38 43 43 
43 43 43 43 35 8 4 5 28 29 7 6 7 6 7 6 7 6 7 6 7 6 7 6 7 6 7 6 25 25 25 25 15 39 32 32 32 32 32 30 25 25 25 25 25 22 12 38 43 43 
43 43 43 43 35 27 28 29 4 5 4 5 4 5 4 5 4 5 4 5 4 5 4 5 4 5 4 5 25 25 25 25 15 25 25 25 25 25 25 25 25 25 25 25 22 12 31 36 43 43 
43 43 43 43 35 27 4 5 28 29 28 29 28 29 28 29 28 29 28 29 28 29 28 29 28 29 28 29 7 6 25 25 14 11 26 26 24 13 23 25 25 25 22 13 12 31 36 42 43 43 
43 43 43 43 33 37 2 3 4 5 4 5 4 25 4 5 4 5 4 5 4 5 4 5 4 5 4 5 4 5 25 25 25 25 25 25 7 6 15 25 25 22 12 31 41 36 42 43 43 43 
43 43 43 43 42 35 1 0 2 3 2 3 2 3 2 3 2 3 2 3 2 3 2 3 2 3 2 3 2 3 25 25 25 25 25 25 2 3 14 13 13 12 31 36 42 42 43 43 43 43 
43 43 43 43 43 33 41 37 1 0 1 0 1 0 1 0 1 0 1 0 1 0 1 0 1 0 1 0 1 0 25 25 25 25 25 25 1 0 27 31 41 41 36 42 43 43 43 43 43 43 
43 43 43 43 43 42 42 33 41 41 41 41 41 41 41 41 41 41 41 41 41 41 41 41 41 41 41 41 41 41 41 41 41 41 41 41 41 41 41 36 42 42 42 43 43 43 43 43 43 43 
43 43 43 43 43 43 43 42 42 42 42 42 42 42 42 42 42 42 42 42 42 42 42 42 42 42 42 42 42 42 42 42 42 42 42 42 42 42 42 42 43 43 43 43 43 43 43 43 43 43 
43 43 43 43 43 43 43 43 43 43 43 43 43 43 43 43 43 43 43 43 43 43 43 43 43 43 43 43 43 43 43 43 43 43 43 43 43 43 43 43 43 43 43 43 43 43 43 43 43 43 
43 43 43 43 43 43 43 43 43 43 43 43 43 43 43 43 43 43 43 43 43 43 43 43 43 43 43 43 43 43 43 43 43 43 43 43 43 43 43 43 43 43 43 43 43 43 43 43 43 43 
43 43 43 43 43 43 43 43 43 43 43 43 43 43 43 43 43 43 43 43 43 43 43 43 43 43 43 43 43 43 43 43 43 43 43 43 43 43 43 43 43 43 43 43 43 43 43 43 43 43 
