22 22 22 22 22 22 22 22 22 22 22 22 22 22 22 22 22 22 22 22 22 22 22 22 22 22 22 22 22 22 22 22 22 22 22 22 22 22 22 22 22 22 22 22 22 22 22 22 22 22
22 23 23 23 23 23 23 23 23 23 23 23 23 23 23 23 23 23 23 23 23 23 23 23 23 23 23 23 23 23 23 23 23 23 23 23 23 23 23 23 23 23 23 23 23 23 23 23 23 22
22 23 23 23 23 23 23 23 23 23 23 23 23 23 23 23 23 23 23 23 23 23 23 38 32 41 23 23 23 23 23 23 23 23 23 23 23 23 23 23 23 23 23 23 23 23 23 23 23 22
22 23 23 23 23 23 23 23 23 23 23 23 23 23 23 23 23 23 23 23 23 38 32 39 20 19 32 32 41 38 32 32 41 23 23 23 23 23 23 23 23 23 23 23 23 23 23 23 23 22
22 23 23 23 23 23 23 23 23 23 23 23 23 23 23 23 23 23 23 38 32 39 21 20 20 20 25 21 19 39 16 15 34 23 23 23 23 23 23 23 23 23 23 23 23 23 23 23 23 22
22 23 23 23 23 23 23 23 23 23 23 23 23 23 23 23 23 23 38 39 25 21 20 20 20 20 20 25 21 21 14 13 34 23 23 23 23 23 23 23 23 23 23 23 23 23 23 23 23 22
22 23 23 23 23 23 23 23 23 23 23 23 23 23 23 23 23 38 39 21 25 20 20 20 20 20 20 20 16 15 30 31 34 23 23 23 23 23 23 23 23 23 23 23 23 23 23 23 23 22
22 23 23 23 23 23 23 23 23 23 23 23 23 23 23 23 38 39 21 25 25 20 20 20 20 20 20 20 14 13 14 13 34 23 23 23 23 23 23 23 23 23 23 23 23 23 23 23 23 22
22 23 23 23 23 23 23 23 23 38 32 32 32 32 32 32 39 25 25 21 20 20 20 20 20 20 20 20 30 31 30 31 34 23 38 32 32 32 32 32 32 32 32 32 41 23 23 23 23 22
22 23 23 23 23 23 23 38 32 39 16 15 16 15 16 15 16 15 16 15 20 20 20 20 20 20 20 20 14 13 14 13 34 23 33 20 20 20 20 20 20 20 20 20 34 23 23 23 23 22
22 23 23 23 23 23 23 33 16 15 14 13 14 13 14 13 14 13 14 13 20 20 20 20 20 20 20 20 30 31 30 31 34 23 33 20 20 20 20 20 20 20 20 20 34 23 23 23 23 22
22 23 23 38 32 32 32 39 14 13 30 31 12 11 12 11 12 11 12 11 20 20 20 20 20 20 20 20 14 13 14 13 34 23 33 20 20 20 20 20 20 20 20 20 34 23 23 23 23 22
22 23 23 33 16 15 16 15 30 31 14 13 10 29 10 29 10 29 10 29 20 20 20 20 20 20 20 20 30 31 30 31 34 23 33 20 20 20 20 20 20 20 20 20 34 23 23 23 23 22
22 23 23 33 14 13 14 13 14 13 12 11 20 20 20 20 20 20 20 20 20 20 20 20 20 20 20 20 14 13 14 13 34 23 33 20 20 20 20 20 20 20 20 20 34 23 23 23 23 22
22 23 23 33 12 11 12 11 30 31 10 29 20 20 20 20 20 20 20 20 20 20 20 20 20 20 20 20 12 11 12 11 34 23 33 20 20 20 20 20 20 20 20 20 34 23 23 23 23 22
22 23 23 33 10 29 10 29 14 13 16 15 20 20 20 20 20 20 20 20 20 20 20 20 20 20 20 20 10 29 10 29 19 32 39 20 20 20 20 20 20 20 20 20 34 23 23 23 23 22
22 23 38 39 20 20 20 20 12 11 14 13 20 20 20 16 15 20 16 15 20 20 20 20 20 20 20 20 20 25 25 21 25 21 21 25 21 27 26 26 26 28 36 17 35 23 23 23 23 22
22 23 33 20 20 20 20 20 10 29 12 11 20 20 20 14 13 20 14 13 20 20 20 20 20 20 20 20 20 20 20 20 20 20 20 20 21 27 26 26 26 28 34 18 23 23 23 23 23 22
22 23 33 20 20 20 20 20 20 20 10 29 20 20 20 12 11 20 12 11 21 16 15 16 15 20 20 20 20 20 20 20 20 20 20 20 20 20 20 20 20 20 34 23 23 23 23 23 23 22
22 23 33 20 20 20 20 20 20 20 20 20 20 20 20 10 29 20 10 29 25 14 13 14 13 20 20 20 20 20 20 20 20 20 20 20 36 17 17 17 17 17 35 23 23 23 23 23 23 22
22 23 33 20 20 20 20 20 20 20 20 20 20 20 20 16 15 16 15 16 15 30 31 30 31 20 20 20 20 20 20 20 20 20 21 21 34 18 18 18 18 18 23 23 23 23 23 23 23 22
22 23 33 20 20 20 20 20 20 20 20 20 20 20 20 14 13 14 13 14 13 14 13 14 13 20 20 20 20 20 20 20 20 20 21 21 34 23 23 23 23 23 23 23 23 23 23 23 23 22
22 23 33 20 20 20 20 20 20 20 20 20 20 20 20 12 11 12 11 12 11 12 11 12 11 20 20 20 20 20 20 20 20 20 21 36 35 23 23 23 23 23 23 23 23 23 23 23 23 22
22 23 33 20 20 20 20 20 20 20 20 20 20 20 20 10 29 10 29 10 29 10 29 10 29 20 20 20 20 20 20 20 20 20 21 19 32 32 32 32 32 32 32 32 32 32 32 41 23 22
22 23 33 20 20 20 20 20 20 20 20 20 20 20 20 20 20 20 20 20 20 20 20 20 20 20 20 20 20 20 20 20 20 20 20 20 20 20 20 20 20 20 20 20 20 20 20 34 23 22
22 23 33 20 20 20 20 20 20 20 20 20 20 20 20 20 20 20 20 20 20 20 20 20 20 20 20 20 20 20 20 20 20 20 20 20 20 20 20 20 20 20 20 20 42 20 20 34 23 22
22 23 33 20 20 20 20 20 20 20 20 20 20 20 20 20 20 20 20 16 15 20 20 20 20 20 20 20 20 20 20 20 20 20 36 17 17 17 17 17 17 17 17 17 17 17 17 35 23 22
22 23 33 20 20 20 20 20 20 20 20 20 20 20 20 20 20 20 20 14 13 16 15 16 15 16 15 16 15 16 15 36 17 17 35 18 18 18 18 18 18 18 18 18 18 18 18 23 23 22
22 23 37 40 20 20 20 20 20 20 20 20 20 20 20 20 20 20 20 12 11 14 13 14 13 14 13 14 13 14 13 34 18 18 18 23 23 23 23 23 23 23 23 23 23 23 23 23 23 22
22 23 23 37 40 20 20 20 20 20 20 20 20 20 16 15 20 20 20 10 29 30 31 30 31 30 31 30 31 30 31 34 23 23 23 23 23 23 23 23 23 23 23 23 23 23 23 23 23 22
22 23 23 23 37 40 16 15 20 20 20 20 20 20 14 13 20 20 20 21 25 14 13 14 13 14 13 14 13 14 13 34 23 23 23 23 23 23 23 23 23 23 23 23 23 23 23 23 23 22
22 23 23 23 23 33 14 13 20 20 16 15 16 15 30 31 20 20 20 25 25 12 11 12 11 12 11 12 11 12 11 34 23 23 23 23 23 23 23 23 23 23 23 23 23 23 23 23 23 22
22 23 23 23 23 33 12 11 20 20 14 13 14 13 14 13 20 20 20 21 25 10 29 10 29 10 29 10 29 10 29 34 23 23 23 23 23 23 23 23 23 23 23 23 23 23 23 23 23 22
22 23 23 23 23 33 10 29 20 20 30 31 30 31 30 31 20 20 20 20 20 21 21 21 25 25 25 25 25 25 25 34 23 23 23 23 23 23 23 23 23 23 23 23 23 23 23 23 23 22
22 23 23 23 23 33 16 15 20 20 14 13 14 13 14 13 20 20 20 20 20 20 20 21 25 20 20 20 20 20 25 34 23 23 23 23 23 23 23 23 23 23 23 23 23 23 23 23 23 22
22 23 23 23 23 33 14 13 20 20 30 31 30 31 30 31 20 20 20 20 20 20 20 20 20 20 20 20 20 20 25 34 23 23 23 23 23 23 23 23 23 23 23 23 23 23 23 23 23 22
22 23 23 23 23 33 12 11 20 20 14 13 14 13 14 13 20 20 20 20 20 20 20 21 25 20 20 20 20 20 25 34 23 23 23 23 23 23 23 23 23 23 23 23 23 23 23 23 23 22
22 38 32 32 32 39 10 29 20 20 30 31 30 31 30 31 20 20 20 20 20 20 21 21 25 20 20 20 20 20 25 34 23 23 23 23 23 23 23 23 23 23 23 23 23 23 23 23 23 22
22 33 16 15 16 15 16 15 20 20 14 13 14 13 14 13 20 20 36 17 17 17 17 17 17 17 17 17 17 17 17 35 23 23 23 23 23 23 23 23 23 23 23 23 23 23 23 23 23 22
22 33 14 13 14 13 14 13 20 20 12 11 30 31 30 31 20 20 34 18 18 18 18 18 18 18 18 18 18 18 18 18 23 23 23 23 23 23 23 23 23 23 23 23 23 23 23 23 23 22
22 33 12 11 12 11 12 11 20 20 10 29 14 13 14 13 20 20 34 23 23 23 23 23 23 23 23 23 23 23 23 23 23 23 23 23 23 23 23 23 23 23 23 23 23 23 23 23 23 22
22 33 10 29 10 29 10 29 20 20 20 20 30 31 30 31 20 20 34 23 23 23 23 23 23 23 23 23 23 23 23 23 23 23 23 23 23 23 23 23 23 23 23 23 23 23 23 23 23 22
22 37 40 20 20 20 20 20 20 20 20 20 14 13 14 13 20 20 34 23 23 23 23 23 23 23 23 23 23 23 23 23 23 23 23 23 23 23 23 23 23 23 23 23 23 23 23 23 23 22
22 23 33 20 20 20 20 20 20 20 20 20 12 11 12 11 20 20 34 23 23 23 23 23 23 23 23 23 23 23 23 23 23 23 23 23 23 23 23 23 23 23 23 23 23 23 23 23 23 22
22 23 33 20 20 20 20 20 20 20 20 20 10 29 10 29 20 20 34 23 23 23 23 23 23 23 23 23 23 23 23 23 23 23 23 23 23 23 23 23 23 23 23 23 23 23 23 23 23 22
22 23 33 20 20 20 20 20 20 20 20 20 20 20 20 20 20 20 34 23 23 23 23 23 23 23 23 23 23 23 23 23 23 23 23 23 23 23 23 23 23 23 23 23 23 23 23 23 23 22
22 23 37 40 20 20 20 20 20 20 20 20 20 20 20 20 20 20 34 23 23 23 23 23 23 23 23 23 23 23 23 23 23 23 23 23 23 23 23 23 23 23 23 23 23 23 23 23 23 22
22 32 32 39 20 20 20 20 20 20 20 20 20 20 20 20 20 20 34 23 23 23 23 23 23 23 23 23 23 23 23 23 23 23 23 23 23 23 23 23 23 23 23 23 23 23 23 23 23 22
22 17 17 17 17 17 17 17 17 17 17 17 17 17 17 17 17 17 35 23 23 23 23 23 23 23 23 23 23 23 23 23 23 23 23 23 23 23 23 23 23 23 23 23 23 23 23 23 23 22
22 22 22 22 22 22 22 22 22 22 22 22 22 22 22 22 22 22 22 22 22 22 22 22 22 22 22 22 22 22 22 22 22 22 22 22 22 22 22 22 22 22 22 22 22 22 22 22 22 22