30 30 30 30 30 30 30 30 30 30 30 30 30 30 30 30 30 30 30 30 30 30 30 30 30 30 30 30 30 30 30 30 30 30 30 30 30 30 30 30 30 30 30 30 30 30 30 30 30 30 
30 30 30 30 30 30 30 30 30 30 30 30 30 30 30 30 30 30 30 30 30 30 30 30 30 30 30 30 30 30 30 30 30 30 30 30 30 30 30 30 30 30 30 30 30 30 30 30 30 30 
30 30 30 30 30 30 36 31 31 31 31 31 31 43 30 30 30 30 30 30 30 30 30 30 30 30 30 30 30 30 30 30 30 30 30 30 30 30 30 30 30 30 30 30 30 30 30 30 30 30 
30 30 30 30 30 30 34 25 27 25 7 6 25 40 43 30 30 30 30 30 30 30 30 30 30 30 30 30 30 30 30 30 30 30 30 30 30 30 30 30 30 30 30 30 30 30 30 30 30 30 
30 30 36 31 31 31 32 27 25 25 4 5 25 25 37 30 30 30 30 30 30 30 30 30 30 30 30 30 30 30 30 30 30 30 30 30 30 30 30 30 30 30 30 30 30 30 30 30 30 30 
36 31 32 25 27 25 25 25 25 25 2 3 25 25 40 31 31 31 31 31 43 30 30 30 30 30 30 30 36 31 31 31 43 30 30 30 30 30 30 30 30 30 30 30 30 30 30 30 30 30 
34 27 25 25 25 25 25 25 25 25 1 0 25 7 6 7 6 25 25 27 37 30 30 30 30 30 30 30 34 25 25 25 40 31 31 31 43 30 30 30 30 30 30 30 30 30 30 30 30 30 
34 25 25 25 25 25 25 25 25 25 25 25 25 4 5 4 5 25 25 25 40 31 43 30 36 31 31 31 32 25 25 25 25 25 25 25 40 31 43 30 30 30 30 30 30 30 30 30 30 30 
34 25 25 25 25 25 25 25 25 25 25 25 25 2 3 2 3 25 25 25 25 25 40 31 32 25 25 25 25 25 25 25 25 25 25 25 25 25 40 43 30 30 30 30 30 30 30 30 30 30 
34 25 25 25 25 25 25 25 25 25 25 25 25 1 0 1 0 25 25 25 25 25 25 25 25 25 25 25 25 25 25 25 25 25 25 25 25 25 25 37 30 30 30 30 30 30 30 30 30 30 
34 25 25 25 25 25 25 25 25 25 25 25 25 25 25 25 25 25 25 25 25 25 25 25 25 25 25 25 25 25 25 25 25 25 25 25 25 25 25 40 43 30 30 30 30 30 30 30 30 30 
34 25 25 25 25 25 25 25 25 25 25 25 25 25 25 25 25 25 25 25 25 25 25 25 25 25 25 25 25 25 25 25 25 25 25 25 25 25 25 25 37 30 30 30 30 30 30 30 30 30 
34 25 25 25 25 25 25 25 25 25 25 25 25 25 25 25 25 25 25 25 25 25 25 25 25 25 25 25 25 25 25 25 25 25 25 25 25 25 25 25 37 30 30 30 30 30 30 30 30 30 
34 25 25 25 25 25 25 25 25 25 25 25 25 25 25 25 25 25 25 25 25 25 25 25 25 25 25 25 25 25 25 25 25 25 25 25 25 25 7 6 37 30 30 30 30 30 30 30 30 30 
34 25 25 25 25 7 6 25 25 25 25 25 25 25 25 25 25 25 25 25 25 25 25 25 25 25 25 25 25 25 25 25 25 25 25 25 25 25 4 5 37 30 30 30 30 30 30 30 30 30 
34 27 25 25 25 4 5 25 7 6 25 25 25 25 25 25 25 25 25 25 25 25 25 25 25 25 25 25 25 25 25 25 25 25 25 25 7 6 28 29 37 30 30 30 30 30 30 30 30 30 
34 25 25 27 25 28 29 25 4 5 7 6 7 6 25 25 25 25 25 25 25 25 25 25 25 25 25 25 25 25 25 25 25 25 25 25 4 5 4 5 37 30 30 30 30 30 30 30 30 30 
35 41 39 25 27 4 5 8 28 29 4 5 4 5 27 7 6 7 6 25 25 25 25 25 25 25 25 25 25 25 25 25 25 25 25 25 28 29 2 3 37 30 30 30 30 30 30 30 30 30 
42 42 35 39 25 2 3 25 4 5 28 29 28 29 25 4 5 4 5 7 6 7 6 7 6 7 6 7 6 25 25 25 25 25 25 25 4 5 1 0 37 30 30 30 30 30 30 30 30 30 
42 42 42 35 39 1 0 25 2 3 4 5 4 5 25 28 29 28 29 4 5 4 5 4 5 4 5 4 5 25 25 25 25 25 25 25 28 29 25 33 38 30 30 30 30 30 30 30 30 30 
42 42 42 42 35 41 41 39 1 0 2 3 2 3 25 4 5 4 5 28 29 28 29 28 29 28 29 28 29 25 25 25 25 25 25 25 4 5 25 37 42 30 30 30 30 30 30 30 30 30 
42 42 42 42 42 42 42 35 41 39 1 0 1 0 27 2 3 2 3 4 5 4 5 4 5 4 5 4 5 25 25 25 25 25 25 25 2 3 33 38 42 30 30 30 30 30 30 30 30 30 
30 30 42 42 42 42 42 42 42 35 41 41 41 41 39 1 0 1 0 2 3 2 3 2 3 2 3 2 3 25 25 25 25 25 25 25 1 0 37 42 42 30 30 30 30 30 30 30 30 30 
30 30 30 30 42 42 42 42 42 42 42 42 42 42 35 41 41 41 39 1 0 1 0 1 0 1 0 1 0 25 25 25 25 25 25 25 33 41 38 42 30 30 30 36 31 31 31 31 31 31 
30 30 30 30 42 42 42 42 42 42 42 42 42 42 42 42 42 42 35 41 41 41 41 41 41 41 41 41 41 39 25 25 25 25 25 33 38 42 42 42 42 42 36 32 8 27 27 27 25 25 
30 30 30 30 30 30 30 30 30 42 42 42 42 42 42 42 42 42 42 42 42 42 42 42 42 42 42 42 42 34 25 25 25 25 25 37 42 42 36 31 31 31 32 25 25 21 20 20 20 20 
30 30 30 30 30 30 30 30 30 30 30 30 30 30 30 30 30 42 42 42 42 42 42 42 42 42 42 42 42 34 25 25 25 25 25 37 42 42 34 25 25 27 25 27 21 17 25 25 25 25 
30 30 30 30 30 30 30 30 30 30 30 30 30 30 30 30 30 30 30 30 30 30 30 30 30 30 30 36 31 32 25 25 25 25 25 40 31 31 32 8 27 25 25 21 17 9 9 9 9 9 
30 30 30 30 30 30 30 30 30 30 30 30 30 30 30 30 30 30 30 30 30 30 30 30 30 30 30 34 25 25 25 25 25 25 25 21 20 20 20 20 20 20 21 17 25 9 25 25 25 9 
30 30 30 30 30 30 30 30 30 30 36 31 31 31 31 31 43 30 30 30 30 30 30 30 30 30 36 32 25 25 25 25 25 25 25 14 27 25 25 25 25 25 14 25 25 9 25 25 44 9 
30 30 30 30 30 30 30 30 30 36 32 25 25 25 25 25 40 31 31 31 31 31 31 31 31 31 32 25 25 25 25 25 25 25 25 14 27 25 25 25 25 21 17 25 25 9 25 9 9 9 
30 30 30 30 30 30 30 30 30 34 25 25 25 25 25 25 25 25 25 25 25 25 25 25 25 25 25 25 25 25 25 25 25 25 25 14 25 25 25 25 25 14 25 25 25 25 25 25 25 27 
30 30 30 30 30 30 30 30 30 34 25 25 25 25 25 25 25 25 25 25 25 25 25 25 25 25 25 25 25 25 25 25 25 25 25 14 25 25 25 25 25 14 8 27 25 25 25 25 25 27 
30 30 30 30 30 30 30 30 36 32 21 20 20 20 11 26 24 20 19 7 6 25 25 25 25 25 25 25 25 25 25 25 25 25 25 14 25 25 25 25 25 14 27 25 25 25 25 25 27 27 
30 30 30 30 30 30 30 36 32 25 14 21 20 20 11 26 24 19 18 4 5 25 25 25 25 25 25 25 25 25 25 25 25 25 25 14 25 25 25 25 25 14 25 25 25 25 25 25 33 41 
30 30 30 30 30 30 30 34 25 21 17 14 25 25 11 26 24 18 18 4 5 7 6 25 25 25 25 25 25 25 25 25 25 25 25 14 25 25 25 25 25 14 25 25 25 25 33 41 38 42 
30 30 30 30 36 31 31 32 25 14 21 17 25 25 25 25 25 18 18 28 29 4 5 7 6 7 6 7 6 25 25 25 25 21 26 17 25 25 25 25 25 14 25 25 25 25 37 42 42 42 
30 30 36 31 32 21 20 20 20 17 14 25 25 25 25 25 25 18 18 4 5 4 5 4 5 4 5 4 5 25 25 25 25 14 25 25 25 25 25 21 26 17 25 25 25 25 37 42 42 42 
30 36 32 21 20 17 21 20 20 20 17 25 25 25 25 25 25 18 18 28 29 28 29 28 29 28 29 28 29 25 25 25 25 14 25 25 25 25 25 14 25 25 25 25 25 25 40 43 42 42 
30 34 21 17 21 20 17 25 25 25 25 25 25 25 25 25 25 18 18 4 5 4 5 4 5 4 5 4 5 7 6 7 6 14 25 25 25 27 25 15 23 25 25 25 25 25 25 37 42 30 
31 32 14 21 17 25 25 25 25 25 25 25 25 25 25 25 25 18 18 2 3 2 3 2 3 2 3 4 5 4 5 4 5 15 23 25 25 25 25 25 15 12 23 25 25 25 25 40 43 30 
20 20 17 14 27 25 25 25 25 25 25 25 25 25 25 25 25 18 18 1 0 1 0 1 0 1 0 2 3 2 3 2 3 25 15 23 27 25 27 25 25 25 15 23 25 8 25 25 37 30 
21 20 20 17 25 25 25 25 25 25 25 25 25 25 25 25 25 13 18 25 33 41 41 41 41 41 39 1 0 1 0 1 0 25 27 15 12 12 12 12 23 25 25 15 12 23 25 25 40 43 
14 25 25 25 25 25 25 25 25 25 25 25 25 25 27 27 22 12 13 33 38 42 42 42 42 42 35 39 27 27 27 25 25 25 33 41 41 39 25 27 14 27 27 25 25 14 25 25 25 37 
14 25 25 25 25 25 25 25 25 25 25 25 25 27 22 12 13 33 41 38 42 42 42 42 42 42 42 35 41 39 25 27 25 33 38 42 42 35 39 25 14 25 27 25 25 14 25 25 25 37 
14 25 25 25 25 25 25 25 25 25 25 25 25 25 18 33 41 38 42 42 42 42 42 42 42 42 42 42 42 35 41 41 41 38 42 42 42 42 35 39 15 12 12 12 12 14 25 25 25 40 
14 25 25 25 25 25 25 25 25 25 25 25 27 25 18 37 42 42 42 42 42 42 30 30 30 30 30 42 42 42 42 42 42 42 42 42 42 42 42 35 39 25 7 6 25 15 14 25 7 6 
14 25 25 25 25 25 25 25 25 25 25 25 25 22 13 37 42 42 42 30 30 30 30 30 30 30 30 30 30 42 42 42 42 42 30 30 30 30 42 42 34 25 4 5 7 6 14 25 4 5 
14 27 25 25 25 25 25 25 27 25 25 27 22 13 33 38 42 42 30 30 30 30 30 30 30 30 30 30 30 30 30 30 30 30 30 30 30 30 30 42 35 39 2 3 4 5 15 14 2 3 
15 12 12 12 12 12 12 12 12 12 12 12 13 33 38 42 42 30 30 30 30 30 30 30 30 30 30 30 30 30 30 30 30 30 30 30 30 30 30 42 42 34 1 0 2 3 25 14 1 0 
