25 25 25 25 25 25 25 25 25 25 25 25 25 25 25 25 25 25 25 25 25 25 25 25 25 25 25 25 25 25 25 25 25 25 25 25 25 25 25 25 25 25 25 25 25 25 25 25 25 25 
25 21 20 20 20 20 20 20 20 20 20 20 20 20 20 20 20 20 20 20 20 20 20 20 20 20 20 20 20 20 20 20 20 20 20 20 20 20 20 20 20 20 20 20 20 20 20 20 19 25 
25 14 25 25 25 25 25 25 25 25 25 25 25 25 25 25 25 25 25 25 25 25 25 25 25 25 25 25 25 25 25 25 25 25 25 25 25 25 25 25 25 25 25 25 25 25 25 25 18 25 
25 14 25 21 20 20 19 25 25 25 25 25 25 25 25 25 25 25 25 25 25 25 25 25 25 25 25 25 25 25 25 25 25 25 25 25 25 25 25 25 25 25 25 25 25 25 25 25 18 25 
25 14 25 14 25 25 18 25 25 25 25 25 25 25 25 25 25 25 25 25 25 25 25 25 25 25 25 25 25 25 25 25 25 25 25 25 25 25 25 25 25 25 25 25 25 25 25 25 18 25 
25 14 25 14 25 44 18 25 25 25 25 25 25 25 25 25 25 25 25 25 25 21 20 20 20 20 20 20 20 20 20 20 20 20 20 20 19 25 25 25 25 25 25 25 25 25 25 25 18 25 
25 14 25 14 25 25 18 25 25 25 25 25 25 25 25 25 25 25 25 25 25 14 25 25 25 25 25 25 25 25 25 25 25 25 25 25 18 25 25 25 25 25 25 25 25 25 25 25 18 25 
25 14 25 14 25 25 18 25 25 25 25 25 25 25 25 25 25 25 25 25 25 14 25 25 25 25 25 25 25 25 25 25 25 25 25 25 18 25 25 25 25 25 25 25 25 25 25 25 18 25 
25 14 25 14 25 25 18 25 25 25 25 25 25 25 25 25 25 25 25 25 25 14 25 25 22 12 12 12 12 12 12 12 23 25 25 25 18 25 25 25 25 25 25 25 25 25 25 25 18 25 
25 14 25 14 25 25 18 25 25 25 25 25 25 25 25 25 25 25 25 25 25 14 25 25 18 25 25 25 25 25 25 25 14 25 25 25 18 25 25 25 25 25 25 25 25 25 25 25 18 25 
25 14 25 14 25 25 18 25 25 25 25 25 25 25 25 25 25 25 25 25 25 14 25 25 18 25 25 25 25 25 25 25 14 25 25 25 18 25 25 25 25 25 25 25 25 25 25 25 18 25 
25 14 25 14 25 25 16 20 20 20 20 20 20 20 20 20 20 20 20 20 20 17 25 25 18 25 25 25 25 25 25 25 14 25 25 25 18 25 25 25 25 25 25 25 25 25 25 25 18 25 
25 14 25 14 25 25 25 25 25 25 25 25 25 25 25 25 25 25 25 25 25 25 25 25 18 25 25 25 25 25 25 25 14 25 25 25 18 25 25 25 25 25 25 25 25 25 25 25 18 25 
25 14 25 14 25 25 25 25 25 25 25 25 25 25 25 25 25 25 25 25 25 25 25 25 18 25 25 25 25 25 25 25 14 25 25 25 18 25 25 25 25 25 25 25 25 25 25 25 18 25 
25 14 25 15 12 12 12 12 12 12 12 12 12 12 12 12 12 12 12 12 12 12 12 12 13 25 25 25 25 25 25 25 14 25 25 25 16 20 20 20 20 20 20 20 20 19 25 25 18 25 
25 14 25 25 25 25 25 25 25 25 25 25 25 25 25 25 25 25 25 25 25 25 25 25 25 25 25 25 25 25 25 25 14 25 25 25 25 25 25 25 25 25 25 25 25 18 25 25 18 25 
25 14 25 25 25 25 25 25 25 25 25 25 25 25 25 25 25 25 25 25 25 25 25 25 25 25 25 25 25 25 25 25 14 25 25 25 25 25 25 25 25 25 25 25 25 18 25 25 18 25 
25 14 25 25 25 25 25 25 25 25 25 25 25 25 25 25 25 25 25 25 25 25 25 25 25 25 25 25 25 25 25 25 14 25 25 25 25 25 25 25 25 25 25 25 25 18 25 25 18 25 
25 14 25 25 25 25 25 25 25 25 25 25 25 25 25 25 25 25 25 25 25 25 25 25 25 25 25 25 25 25 25 25 15 23 25 25 25 25 25 25 25 25 25 25 25 18 25 25 18 25 
25 14 25 25 25 21 20 20 20 20 20 20 20 20 20 20 20 20 20 20 20 20 20 20 20 20 19 25 25 25 25 25 25 14 25 25 25 25 25 25 25 25 25 25 25 18 25 25 18 25 
25 14 25 25 25 14 25 25 25 25 25 25 25 25 25 25 25 25 25 25 25 25 25 25 25 25 18 25 25 25 25 25 25 14 25 25 25 25 25 25 25 25 25 25 25 18 25 25 18 25 
25 14 25 25 25 14 25 25 25 25 25 25 25 25 25 25 25 25 25 25 25 25 25 25 25 25 18 25 25 25 25 25 25 14 25 25 25 25 25 25 25 25 25 25 25 18 25 25 18 25 
25 14 25 25 25 14 25 25 25 25 25 25 25 25 25 25 25 25 25 25 25 25 25 25 25 25 18 25 25 25 25 25 25 14 25 25 25 25 25 25 25 25 25 25 25 18 25 25 18 25 
25 14 25 25 25 14 25 25 25 25 25 25 25 25 25 25 25 25 25 25 25 25 25 25 25 25 18 25 25 25 25 25 25 14 25 25 25 25 25 25 25 25 25 25 25 18 25 25 18 25 
25 14 25 25 25 14 25 25 25 25 25 25 25 25 25 25 25 25 25 25 25 25 25 25 25 25 18 25 25 25 25 25 25 14 25 25 25 25 25 25 25 25 25 25 25 18 25 25 18 25 
25 14 25 25 25 14 25 25 25 25 25 25 25 25 25 25 25 25 25 25 25 25 25 25 25 25 18 25 25 25 25 25 25 14 25 25 25 25 25 25 25 25 25 25 25 18 25 25 18 25 
25 14 25 25 25 14 25 25 25 22 12 12 12 12 12 12 23 25 25 25 25 25 25 25 25 25 18 25 25 25 25 25 25 14 25 25 25 25 25 25 25 25 25 25 25 18 25 25 18 25 
25 14 25 25 25 14 25 25 25 18 25 25 25 25 25 25 14 25 25 25 25 25 25 25 25 25 18 25 25 25 25 25 25 14 25 25 25 25 25 25 25 25 25 25 25 18 25 25 18 25 
25 14 25 25 25 14 25 25 25 18 25 25 25 25 25 25 14 25 25 25 25 25 25 25 25 25 18 25 25 25 25 25 25 14 25 25 25 25 25 25 25 25 25 25 25 18 25 25 18 25 
25 14 25 25 25 14 25 25 25 18 25 25 25 25 25 25 14 25 25 25 25 25 25 25 25 25 18 25 25 25 25 25 25 14 25 25 25 25 25 25 25 25 25 25 25 18 25 25 18 25 
25 14 25 25 25 14 25 25 25 18 25 25 25 25 25 25 14 25 25 25 25 25 25 25 25 25 18 25 25 25 25 25 25 14 25 25 25 25 25 25 25 25 25 25 25 18 25 25 18 25 
25 14 25 25 25 14 25 25 25 18 25 25 25 25 25 25 14 25 25 25 25 25 25 25 25 25 18 25 25 25 25 25 25 14 25 25 25 25 25 25 25 25 25 25 25 18 25 25 18 25 
25 14 25 25 25 14 25 25 25 18 25 25 25 25 25 25 14 25 25 25 25 25 25 25 25 25 18 25 25 25 25 25 25 14 25 25 25 25 25 25 25 25 25 25 25 18 25 25 18 25 
25 14 25 25 25 14 25 25 25 18 25 25 25 25 25 25 14 25 25 25 25 25 25 25 25 25 18 25 25 25 25 25 25 14 25 25 25 25 25 25 25 25 25 25 25 18 25 25 18 25 
25 14 25 25 25 14 25 25 25 18 25 25 25 25 25 25 14 25 25 25 25 25 25 25 25 25 18 25 25 25 25 25 25 15 12 12 12 12 12 12 12 12 23 25 25 18 25 25 18 25 
25 14 25 25 25 14 25 25 25 18 25 25 25 25 25 25 15 12 12 12 12 12 12 12 12 12 13 25 25 25 25 25 25 25 25 25 25 25 25 25 25 25 14 25 25 18 25 25 18 25 
25 14 25 25 25 14 25 25 25 18 25 25 25 25 25 25 25 25 25 25 25 25 25 25 25 25 25 25 25 25 25 25 25 25 25 25 25 25 25 25 25 25 14 25 25 18 25 25 18 25 
25 14 25 25 25 14 25 25 25 18 25 25 25 25 25 25 25 25 25 25 25 25 25 25 25 25 25 25 25 25 25 25 25 25 25 25 25 25 25 25 25 25 14 25 25 18 25 25 18 25 
25 14 25 25 25 14 25 25 25 18 25 25 25 25 25 25 25 25 25 25 25 25 25 25 25 25 25 25 25 25 25 25 25 25 25 25 25 25 25 25 25 25 14 25 25 18 25 25 18 25 
25 14 25 25 25 14 25 25 25 16 20 20 20 20 20 20 20 20 20 20 20 20 20 20 20 20 20 20 20 20 20 20 20 20 20 20 20 20 20 20 20 20 17 25 25 18 25 25 18 25 
25 14 25 25 25 14 25 25 25 25 25 25 25 25 25 25 25 25 25 25 25 25 25 25 25 25 25 25 25 25 25 25 25 25 25 25 25 25 25 25 25 25 25 25 25 18 25 25 18 25 
25 14 25 25 25 14 25 25 25 25 25 25 25 25 25 25 25 25 25 25 25 25 25 25 25 25 25 25 25 25 25 25 25 25 25 25 25 25 25 25 25 25 25 25 25 18 25 25 18 25 
25 14 25 25 25 14 25 25 25 25 25 25 25 25 25 25 25 25 25 25 25 25 25 25 25 25 25 25 25 25 25 25 25 25 25 25 25 25 25 25 25 25 25 25 25 18 25 25 18 25 
25 14 25 25 25 15 12 12 12 12 12 12 12 12 12 12 12 12 12 12 12 12 12 12 12 12 12 12 12 12 12 12 12 12 12 12 12 12 12 12 12 12 12 12 12 13 25 25 18 25 
25 14 25 25 25 25 25 25 25 25 25 25 25 25 25 25 25 25 25 25 25 25 25 25 25 25 25 25 25 25 25 25 25 25 25 25 25 25 25 25 25 25 25 25 25 25 25 25 18 25 
25 14 25 25 25 25 25 25 25 25 25 25 25 25 25 25 25 25 25 25 25 25 25 25 25 25 25 25 25 25 25 25 25 25 25 25 25 25 25 25 25 25 25 25 25 25 25 25 18 25 
25 14 25 25 25 25 25 25 25 25 25 25 25 25 25 25 25 25 25 25 25 25 25 25 25 25 25 25 25 25 25 25 25 25 25 25 25 25 25 25 25 25 25 25 25 25 25 25 18 25 
25 14 25 25 25 25 25 25 25 25 25 25 25 25 25 25 25 25 25 25 25 25 25 25 25 25 25 25 25 25 25 25 25 25 25 25 25 25 25 25 25 25 25 25 25 25 25 25 18 25 
25 15 12 12 12 12 12 12 12 12 12 12 12 12 12 12 12 12 12 12 12 12 12 12 12 12 12 12 12 12 12 12 12 12 12 12 12 12 12 12 12 12 12 12 12 12 12 12 13 25 
25 25 25 25 25 25 25 25 25 25 25 25 25 25 25 25 25 25 25 25 25 25 25 25 25 25 25 25 25 25 25 25 25 25 25 25 25 25 25 25 25 25 25 25 25 25 25 25 25 25 
